abk	?	grey
ara	m'a	red
aze	su	orange
bel	vady	blue
bos	voda	blue
bul	vodi	blue
cat	aigua	yellow
cau	?	grey
ces	voda	blue
cym	dŵr	red
dan	vand	green
deu	wasser	green
ell	neró	red
eng	water	green
est	vesi	red
eus	ura	red
fao	?	grey
fin	vesi	red
fra	eau	yellow
fry	wetter	green
gag	?	grey
gla	ushtey	red
gle	uisce	red
glg	auga	yellow
hrv	voda	blue
hun	víz	red
hye	jur	red
isl	vatn	green
ita	aqua	yellow
kat	tsqali	red
kaz	?	grey
krl	?	grey
lav	ūdens	red
lit	vanduo	red
ltz	waasser	green
mkd	voda	blue
mlt	ilma	red
nld	water	green
nor	vann	green
oss	?	grey
occ	aiga	yellow
pol	woda	blue
por	água	yellow
roh	?	grey
ron	apă	yellow
rus	voda	blue
slk	voda	blue
slv	voda	blue
sme	čáhci	red
spa	agua	yellow
sqi	ujë	red
srp	voda	blue
swe	vatten	green
tat	?	grey
tur	su	orange
ukr	voda  blue
xal	?	grey